6,14,10,14,12,6,10,10,14,10,10,14,10,12
5,7,8,5,7,13,6,10,9,6,10,11,12,5
5,3,12,3,9,3,11,10,8,3,14,12,7,13
3,14,11,10,12,4,6,10,14,10,13,3,13,1
6,11,10,14,9,5,3,12,7,10,15,14,15,12
3,14,10,11,10,13,6,11,13,6,13,5,5,5
6,15,10,14,8,5,7,12,5,5,3,13,1,5
5,5,6,11,12,5,3,9,3,9,4,3,10,13
5,5,7,12,7,11,12,6,10,14,11,12,6,13
7,9,1,3,11,14,9,3,14,11,14,9,5,5
7,10,14,10,8,7,14,14,13,6,11,12,7,9
5,6,11,12,6,13,5,5,5,3,14,15,11,12
5,5,6,9,5,7,9,5,3,14,13,3,12,5
1,3,11,10,11,11,8,3,10,9,3,10,11,9
